                                                                                                                                                                                                                                                    
                                                                                                                                                                                                                                                    
                                                                                                                                                                                                                                                    
                                                                                                                                                                                                                                                    
                                                                                                                                                                                                    OOOOOOOOOOOOOOOOOOO                             
    OOOOOOOOOOOOOOOOOOOOOOOOOOOOOOOOOOOOOOOOOOOOOOOOOOOOOOOOOOOOOOOOOOOOOOOOOOOOOOOOOOOOOOOOOOOOOOOOOOOOOOOOOOOOOOOOOOOOOOOOOOOOOOOOOOOOOOOOOOOOO                                                   O                                               
    O         O                                          O                O                                 O                                   O                                                   O                                               
    O         O                                          O                O                                 O                                   O                                                   O                                               
    O         O                                          O                O                                 O                                   O                                                   O                                               
    O         O                                          O                O                                 O                                   O                                                   O                                               
    O         O                                          O                O                                 O                                   O                                                   O                                               
    O         OOOOOOOOOOOOOOOOOOOOOOOOOOOOOOOOOOOOOOOOOOOOOOOOOOOOOOOOOOOOOOOOOOOOOOOOOOOOOOOOOOOOOOOOOOOOOOOOOOOOOOOOOOOOOOOOOOOOOOOOOOOOOOOOOOOOOOOOOOOOOOOOOOOOOOOOOOOOOOOOOOOOOOOOOOOOOOOOOOOOOOO                                               
    O         O                 O                        O                O                                 O                                                       O                               O                                               
    O         O                 O                        O                O                                 O                                                       O                               O                                               
    O         O                 O                        O                O                                 O                                                       O                               O                                               
    OOOOOOOOOOOOOOOOOOOOOOO     O                OOOOOOOOOOOOOOOOOOOOOOOOOOOOOOOOOOOOOOOOOOOOOOOOOOOOOOOOOOOOOOOOOOOOOOOOOOOOOOOOOOOOOOOOOOOOOOOOOOOOOOOOOOOOOOOOOOOOOOOOOOOOOOOOOOOOOOOOOOOOOOOOOOOO                                               
    O         O           O     O                O               O                     O                    O                           O             O                        O                    O                                               
    O         O           O     O                O               O                     O                    O                           O             O                        O                    O                                               
    O         O           O     O                O               O                     O                    O                           O             O                        O                    O                                               
    O         O           O     O                O               O                     O                    O                           O             O                        O                    OOOOOOOOOOOOOOOOOOOOOOOOOOOOOOO                 
    O         O           O     O                O               O                     O                    O                           O             O                        O                    O                             O                 
    O         O           O     OOOOOOOOOOOOOOOOOO               O                     O                    OOOOOOOOOOOOOOOOOOOOOOOOOOOOO             O                        O                    O                             O                 
    O   OOOOOOOOOOOOOOOOOOO                      O               O                     O                          O                     O             O                        O                    O                             O                 
    O   O         O       O                      O               O                     O                          O                     O             O                        O                    O                             O                 
    O   O         O       O                      O               O                     O                          O                     O             O                        O                    O                             O                 
    OOOOO         O             OOOOOOOOOOOOOOOOOO               O                     OOOOOOOOOOOOOOOOO          O                     OOOOOOOOOOOOOOO                        O                    O                             O                 
                  O             O                                O                     O                          O                           O                                O                    O                             O                 
                  O             O                                O                     O                          O                           O                                O                    O                             O                 
                  O             O                                O                     O                          O                           O                                O                    O                             O                 
                  O             O                                O                     O                          O                           O                                O                    O                             O                 
     OOOOOOOOOOOOOOOOOOOOOO     OOOOOOOOOOOOOOOOOOOOOOOOOOOOOOOOOOOOOOOOOOOOOOOOOOOOOOOOOOOOOOOOOOOOOOOOOOOOOOOOOOO                           OOOOOOOOOOOOOOOOOOOOOOOOOOOOOOOOOOOOOOOOOOOOOOOOOOOOOOOOOOOOOOOOOOOOOOOOOOOOOOOOOOOOO                 
     O                    O                               O                            O                                                      O                                                     O                                               
     O                    O                               O                            O                                                      O                                                     O                                               
     O                    O                               O                            O                                                      O                                                     O                                               
     O                    O                               O                  OOOOOOOOOOOOOOOOOOOOOOOO                    OOOOOOOOOOOOOOOOOOOOOO                                                     O                                               
     O                    O                               O                            O                                                      O                                                     O                                               
     O                    OOOOOOOOOOOOOOOOOOOOOOOOOOOOOOOOO                            O                                                      O                                                     O                                               
     O                                                                                 O                                                      O                                                     O                                               
     O                                                                                 O                                                      O                                                     O                                               
     OOOOOOOOOOOOOOOOOOOOOOOOOOOOOOOOOOOOOOOOOOOOOOOOOOOOOOOOOOOOOOOOOOOOOOOOOOOOOOOOOOOOOOOOOOOOOOOOOOOOOOOOOOOOOOOOOOOOOOOOOOOOOOOOOOOOOOOOOOOOOOOOOOOOOOOOOOOOOOOOOOOOOOOOOOOOOOOOOOOOOOOOOOOOOOOO                                               
     O                                                                                 O                                O                                   O                                       O                                               
     O                                                                                 O                                O                                   O                                       O                                               
     O                                                                                 O                                O                                   O                                       O                                               
     O                                                                                 O                                O                                   OOOOOOOOOOOOOOOOOOOOOOOOOOOOOOOOOOOOOOOOO                                               
     O                                                                                 O                                O                                   O                                                                                       
     OOOOOOOOOOOOOOOOOOOOOOOOOOOOOOOOOOOOOOOOOO                      OOOOOOOOOOOOOOOOOOO                                OOOOOOOOOOOOO                       O                                                                                       
                                                                     O                                                  O                                   O                                                                                       
                                                                     O                                                  O                                   O                                                                                       
                                                                     O                                                  O                                   OOOOOOOOOOOOOOOOOOOOOOOOOOOOOOOOOOOOOOOOOOOOOOOOOOOOOOOOO                               
                                                                     O                  O                               O                                                                                           O                               
                                                                     O                  O                               O                                                                                           O                               
                                                                     O                  O                               O                                                                                           O                               
                                                                     OOOOOOOOOOOOOOOOOOOO                               O                                                                                           O                               
                                                                          O                                             OOOOOOOOOOOOOOOOOOOOOOOOOOOOOOOOOOOOOOOOOOOOOOOOOOOOOOOOOOOOOOOOOOOOOOOOOOOOOOOOOOOOOOOOOOOOO                               
                                                                          O                                                                                                                                         O                               
                                                                          O                                                                                                                                         O                               
                                                                          O                                                                                                                                         O                               
                                                                          O                                                                                                                                         O                               
                                                                          O                                                                                                                         OOOOOOOOOOOOOOOOO                               
    OOOOOOOOOOOOOOOOOOOOOOOOOOOOOOOOOOOOOOOOOOOOOOOOOOOOOOOOOOOOOOOOOOOOOOOOOOOOOOOOOOOOOOOOOOOOOOOOOOOOOOOOOOOOOOOOOOOOOOOOOOOOOOOOOOOOOOOOOOOOO                                                   O                                               
    O         O                                          O                O                                 O                                   O                                                   O                                               
    O         O                                          O                O                                 O                                   O                                                   O                                               
    O         O                                          O                O                                 O                                   O                                                   O                                               
    O         O                                          O                O                                 O                                   O                                                   O                                               
    O         O                                          O                O                                 O                                   O                                                   O                                               
    O         OOOOOOOOOOOOOOOOOOOOOOOOOOOOOOOOOOOOOOOOOOOOOOOOOOOOOOOOOOOOOOOOOOOOOOOOOOOOOOOOOOOOOOOOOOOOOOOOOOOOOOOOOOOOOOOOOOOOOOOOOOOOOOOOOOOOOOOOOOOOOOOOOOOOOOOOOOOOOOOOOOOOOOOOOOOOOOOOOOOOOOO                                               
    O         O                 O                        O                O                                 O                                                       O                               O                                               
    O         O                 O                        O                O                                 O                                                       O                               O                                               
    O         O                 O                        O                O                                 O                                                       O                               O                                               
    OOOOOOOOOOOOOOOOOOOOOOO     O                OOOOOOOOOOOOOOOOOOOOOOOOOOOOOOOOOOOOOOOOOOOOOOOOOOOOOOOOOOOOOOOOOOOOOOOOOOOOOOOOOOOOOOOOOOOOOOOOOOOOOOOOOOOOOOOOOOOOOOOOOOOOOOOOOOOOOOOOOOOOOOOOOOOO                                               
    O         O           O     O                O               O                     O                    O                           O             O                        O                    O                                               
    O         O           O     O                O               O                     O                    O                           O             O                        O                    O                                               
    O         O           O     O                O               O                     O                    O                           O             O                        O                    O                                               
    O         O           O     O                O               O                     O                    O                           O             O                        O                    OOOOOOOOOOOOOOOOOOOOOOOOOOOOOOO                 
    O         O           O     O                O               O                     O                    O                           O             O                        O                    O                             O                 
    O         O           O     OOOOOOOOOOOOOOOOOO               O                     O                    OOOOOOOOOOOOOOOOOOOOOOOOOOOOO             O                        O                    O                             O                 
    O   OOOOOOOOOOOOOOOOOOO                      O               O                     O                          O                     O             O                        O                    O                             O                 
    O   O         O       O                      O               O                     O                          O                     O             O                        O                    O                             O                 
    O   O         O       O                      O               O                     O                          O                     O             O                        O                    O                             O                 
    OOOOO         O             OOOOOOOOOOOOOOOOOO               O                     OOOOOOOOOOOOOOOOO          O                     OOOOOOOOOOOOOOO                        O                    O                             O                 
                  O             O                                O                     O                          O                           O                                O                    O                             O                 
                  O             O                                O                     O                          O                           O                                O                    O                             O                 
                  O             O                                O                     O                          O                           O                                O                    O                             O                 
                  O             O                                O                     O                          O                           O                                O                    O                             O                 
     OOOOOOOOOOOOOOOOOOOOOO     OOOOOOOOOOOOOOOOOOOOOOOOOOOOOOOOOOOOOOOOOOOOOOOOOOOOOOOOOOOOOOOOOOOOOOOOOOOOOOOOOOO                           OOOOOOOOOOOOOOOOOOOOOOOOOOOOOOOOOOOOOOOOOOOOOOOOOOOOOOOOOOOOOOOOOOOOOOOOOOOOOOOOOOOOO                 
     O                    O                               O                            O                                                      O                                                     O                                               
     O                    O                               O                            O                                                      O                                                     O                                               
     O                    O                               O                            O                                                      O                                                     O                                               
     O                    O                               O                  OOOOOOOOOOOOOOOOOOOOOOOO                   EOOOOOOOOOOOOOOOOOOOOOO                                                     O                                               
     O                    O                               O                            O                                                      O                                                     O                                               
     O                    OOOOOOOOOOOOOOOOOOOOOOOOOOOOOOOOO                            O                                                      O                                                     O                                               
     O                                                                                 O                                                      O                                                     O                                               
     O                                                                                 O                                                      O                                                     O                                               
     OOOOOOOOOOOOOOOOOOOOOOOOOOOOOOOOOOOOOOOOOOOOOOOOOOOOOOOOOOOOOOOOOOOOOOOOOOOOOOOOOOOOOOOOOOOOOOOOOOOOOOOOOOOOOOOOOOOOOOOOOOOOOOOOOOOOOOOOOOOOOOOOOOOOOOOOOOOOOOOOOOOOOOOOOOOOOOOOOOOOOOOOOOOOOOOO                                               
     O                                                                                 O                                O                                   O                                       O                                               
     O                                                                                 O                                O                                   O                                       O                                               
     O                                                                                 O                                O                                   O                                       O                                               
     O                                                                                 O                                O                                   OOOOOOOOOOOOOOOOOOOOOOOOOOOOOOOOOOOOOOOOO                                               
     O                                                                                 O                                O                                   O                                                                                       
     OOOOOOOOOOOOOOOOOOOOOOOOOOOOOOOOOOOOOOOOOO                      OOOOOOOOOOOOOOOOOOO                                OOOOOOOOOOOOO                       O                                                                                       
                                                                     O                                                  O                                   O                                                                                       
                                                                     O                                                  O                                   O                                                                                       
                                                                     O                                                  O                                   OOOOOOOOOOOOOOOOOOOOOOOOOOOOOOOOOOOOOOOOOOOOOOOOOOOOOOOOO                               
                                                                     O                  O                               O                                                                                           O                               
                                                                     O                  O                               O                                                                                           O                               
                                                                     O                  O                               O                                                                                           O                               
                                                                     OOOOOOOOOOOOOOOOOOOO                               O                                                                                           O                               
                                                                                                                        OOOOOOOOOOOOOOOOOOOOOOOOOOOOOOOOOOOOOOOOOOOOOOOOOOOOOOOOOOOOOOOOOOOOOOOOOOOOOOOOOOOOOOOOOOOOO                               
                                                                                                                                                                                                                                                    
                                                                                                                                                                                                                                                    
                                                                                                                                                                                                                                                    
                                                                                                                                                                                                                                                                            
                                                                                                                                                                                                                                                    
                                                                                                                                                                                                                                                    
                                                                                                                                                                                                                                                    